11111111111111111111111111111111111111111111
100000000000C10000000000001C1000000000001001
100000000000000000000000PE001000000000001001
11111111111111111111111111111111111111111111