11111111111111111111111111111111111111111111
100000000000C10000000000000C0000000000001001
100000000000000000000000PE000000000000001001
11111111111111111111111111111111111111111111