1111111111111111111
1P001000E0000C00001
10000C0000C00C00001
1000000000000000001
1000000000000000001
1111111111111111111