111111111111111111111
10C0000P10001000000C1
101111111010111011111
100000000010000010001
101110111111101110111
1000100010000000000C1
11101C111111111110111
101010001000100000001
101110111011101011101
100010000000001010001
101C101110E1111111111
1010000010C010C000001
101111111110101111101
100010100C0010000C101
111110101110101111101
100010001000000010101
10101011111111101C111
10C010001000000010001
101111111010111011101
10000C00001000100C001
111111111111111111111