1111111111111111111
1P001000E0000C00001
10X00C0000C00C0X001
1111111111111111111