111111111111111111
1P00000C0000000EC1
10000C000000000001
111111111111111111