1111111111111111111
1P001X00E0X00C000X1
10000C0000000C00001
1111111111111111111