1111111111111111111
1P001000E0000C00001
10000C0000000C00001
1111111101111111111
1000000000000000001
10000X0000000000001
1111111111111111111