1111111111111111111
1P001000E0000C00001
10000C0000C00C0X001
1000000000000000001
10X0000000000000001
1111111111111111111