1111111111111111111
1P001X00E0000C00001
10000C0000X00C00001
1111111111111111111