111111111111111111
1P0000000000000EC1
100000000000000001
111111111111111111