1111111111111111111
1PCE100000000010101
1011100111110000001
10000001000100EE001
1000000111010000001
1111111111111111111