1111111111111111111
1PCE100000000010101
1011100111110000001
1000000100010000001
1000000111010000001
1111111111111111111