1111111111111111111
1PCE10G000000010101
1011100111110000001
10G0000100010000001
1000000111010000001
1111111111111111111
