1111111111111111111
1PCE10000X00001X101
111110011111000X001
100X0001X1X100X0001
10X0000111X10000001
1111111111111111111