1111111111111111111
1PCE10000X00000X001
111110000000000X001
10000000X0000000001
10X000X00000X000001
1111111111111111111