111111111111111111111
10C0000P10001X00000C1
101111111010111011111
10000C00001X000010001
101110111111101110111
100010001000X000000C1
11101C111111111110111
101X10001000100000001
101110111011101011101
100010X00000001X10001
101C101110E1111111111
1010X00010C010C000001
101111111110101111101
100010100C0010000C101
1111101011101X1111101
10001X001000000010101
1X101011111111101C111
10C010001X00X00010001
101111111010111011101
1X000C000010X0100C001
111111111111111111111