1111111111111111111
1PCE10000X00001X101
101110011111000X001
10000001X0X100X0001
10X0000111010000001
1111111111111111111
