1111111111111111111
1PG000000X0X001X101
1E1110011111000X001
10000001X0X10CX0001
1000000111010000001
1111111111111111111
