1111111111111111111
1PCE10000X00001X101
10001001111100X0001
1111100100X100X0001
10X0000100010000001
1111111111111111111
